0000000000000000000000000000000000000000000000000-
0000000020000000000000200000000000000000000000000-
0000000000000000110000000000000004440000000000000-
0000000000000001111000000000000044400000002000000-
0000200000000000110000000200000444000000000000000-
0000000000002000000000000000000000000000000000000-
0000000110000000000020000005550000000200000000000-
0000001100000000000000000055555000000004440000000-
0000011000000004000000000555555500000004440000000-
0000000000000044400000000055555000002000000020000-
0000000002000444440000000005550000000000000000000-
0000000000000044400000200000000000000000000000000-
0000000020000004000000000000000200011100020000000-
0000000000000000000000000000000000001110000000000-
0000000000000000002000000440000000011100000000000-
0000000000000000000000000044000000111000000000000-
0000020000000000000000000004400000000000000002000-
0000000440000000000000200000000000000200000000000-
0000004400000020000000000000000000000000000000000-
0000044400000000000000000000002000000555000000000-
0000044000000000000000000000000000000555000000000-
0000000000550000000000000000000000000555000000000-
0000000000555000000000000000000000200000000020000-
0000020000000000000000044400000000000000003300000-
0000000000555000000200040400000000000000000000000-
0000002000550000000000044400000200000000000000000-
0000000000000000000000000000000000000002000000000-
0002000000020000000000000000000000000000000000000-
0000000000000000000000000000000000004000000000000-
0003000444000000000000000002000000044400000000000-
0000000044400000020000000000000000444440000000000-
0000020004440000000000000000000000044400200000000-
0000000000444000000002000000000000004000000000000-
0033000000044400000000005550000000200000000200000-
0003000000000000000000005550000000000001100000000-
0000000000000200000000000000002000330001110000000-
0000000055500000330000020000000000330000111000000-
0000000555000000330000000000000000000000011100000-
0000005550000000000000000020000000200000000000000-
0000055500004400000030000000000000000002000000000-
0000000000000440000000111100000444000000020000000-
0000000000000000000111110000000444000000000000000-
0000300000200000001111000000000044400020000000000-
0000000000000000000000000000000444000000000020000-
0000000040000200000022000000004440000000000000000-
0030000444000000000000000002000000000000200000000-
0000000040000000220000000000000000000000000000000-
0000000000002000000000000200000000020000000000000-
0000000000000000000000000000000000000000000000000

