0000000000000000000000000000000000000000000000000-
0000000020000000000000300000000000000000000000000-
0000000000000000110000000000200004440000000000000-
0000000300000001111000000000000044400000002000000-
0000000000000000110000000320000444000000000000000-
0000000000000000000000000000000000000000000200000-
0000000110000200000030000005550000000300000000000-
0000001100000000000000000055555000000000000000000-
0000011000000004000000000555555500000000000000000-
0000000000000044400000000055555000002000000030000-
0000000000000444440000000005550000000000000000000-
0000000000000044400000000000000000000000000000000-
0000300020000004000000000000000000011100000000000-
0000000000000000000000000000000000001110000003000-
0000000000000000000000003000000000011100000000000-
0000000000030000000000000000000000111000000000000-
0000020000003000000000000000000000000000000000000-
0000000000000000000000200000000000000000000000000-
0000000000000000000000000000000000000000030000000-
0000044000000000000000000000002000000555000000000-
0000044000000000002000000000000000000555000000000-
0000000000550000000000000000000000000555000200000-
0000000000055000000000000000000000000000000020000-
0000000000000000000000044400000003000000000000000-
0000000000055000000000040400000000000000000000000-
0000000000550000000000044400000000000000000020000-
0000000000000000000000000000000000000000000000000-
0002000000000000000000000002000000000000000000000-
0000000000000000300000000000000000004000000000000-
0000000444000000300000000000000000044400000000000-
0000000044400000000000000200000000444440000020000-
0000000004440000000000000000030000044400000000000-
0000000000444000002000000000000000004000000000000-
0033000000044400000000005500000000000000000000000-
0003000000000000000000005500000000300001100002000-
0000000000000000000000000000002200000001110000000-
0000000055500000330000002000000000000000111000000-
00000005550000003300000200000030000000000011000000-
0000005550000000000000000000000000000000000000000-
0000055500004400000000000000000000000000000000000-
0000000000000440000000111100000444000000020000000-
0000000000000000000111110000000444000000000000000-
0000300000000000001111000000000044400000000000000-
0000000000000000000000000000000444000000000000000-
0000000040000000000033000000004440000000000000000-
0000000444000000000000000000000000000000000000000-
0000000040000000330000000000000000000000000000000-
0000000000000000000000000000000000000000000000000-
0000000000000000000000000000000000000000000000000

