1111111111000000000000000000000000000000000000000-
0000002222222222222222222222222222222222222000000-
0000000000000000000000000000000000000000000000000-
0000000000000000000000000000000000000000000000000-
0000000000000000000000000000000000000000000000000-
0000000000000000000000000000000000000000000000000-
0000000000000000000000000000000000000000000000000-
0000000000000000000000000000000000000000000000000-
0000000000000000000000000000000000000000000000000-
0000000000000000000000000000000000000000000000000-
0000000000000000000000000000000000000000000000000-
0000000000000000000000000000000000000000000000000-
0000000000000000000000000000000000000000000000000-
0000000000000000000000000000000000000000000000000-
0000000000000000000000000000000000000000000000000-
0000000000000000000000000000000000000000000000000-
0000000000000000000000000000000000000000000000000-
0000000000000000000000000000000000000000000000000-
0000000000000000000000000000000000000000000000000-
0000000000000000000000000000000000000000000000000-
0000000000000000000000000000000000000000000000000-
0000000000000000000000000000000000000000000000000-
0000003330000000002222002222002200000000000000000-
0000003333330000000000000000000000000000000000000-
0000003330000000000200000000000200000000000000000-
0000003330000000000000000000000000000000000000000-
0000000000000000000220202202222200000000000000000-
0000000000000000000000000000000000000000000000000-
0000000033300000000000000000000000000000000000000-
0000000033300000000000000000000000000000000000000-
0000000033300000000000000000000000000000000000000-
0000000000000000000000000000000000000000000000000-
0000000000000000000000000000000000000000000000000-
0000000000000000000000000000000000000000000000000-
0000000000000000000000000000000000000000000000000-
0000000000000000000000000000000000000000000000000-
0000000000020000020000000000000000000000000000000-
0000000000000000000000000000000000000000000000000-
0000000000000000000000000000000000000000000000000-
0000000000000000000000000000000000000000000000000-
0000000000000000000000000000000000000000000000000-
0000000000020000020000000000000000000000000000000-
0000000000000000000000000000000000000000000000000-
0000000000000000000000000000000000000000000000000-
0000000000000000000000000000000000000000000000000-
0000000000000000000000000000000000000000000000000-
0000000000000000000000000000000000000000000000000-
0000002222222222222222222222222222222222222000000-
0000000000000000000000000000000000000000000000000

